....................................................................................................................................................
....................................................................................................................................................
....................................................................................................................................................
....................................................................................................................................................
....................................................................................................................................................
....................................................................................................................................................
....................................................................................................................................................
...................................................................................................................................................W
...................................................................................................................................................W
...................................................................................................................................................W
...................................................................................!....1.......................!..................................W
...................................................................................WWWWWWWWWWWWWWWWWWWWWWWWWWWWWW..................................W
..............................................................................WWWWWW............................WWWWWW...1.............!.........F.W
W......*...........................*.....................................WWWWWW.................................W....WWWWWWWWWWWWWWWWWWW.......WWWWW
W......*..........................***...............................WWWWWW....W...!*************1**************.W...........................WWWW***W
W......W..................W..1...WWWWWW..1...W.............C...WWWWWW.........W...WWWWWWWWWWWWWWWWWWWWWWWWWWWWWWW........................WWWW******W
W.S...WWW....1....1.....WWWWWWWWWWWWWWWWWWWWWWWW..........WWWWWW..............W.......................................................WWWW*********W
WWWWWWWWWWWWWWWWWWWWWWWWWWWWWWWWWWWWWWWWWWWWWWWWWWWWWWWWWWW...................WWWWWWWWWWWWWWWWWWWWWWWWWWWWWWWWWWWWWWWWWWWWWWWWWWWWWWWWWWWWWWWWWWWWWW    