...........................................................
...........................................................
S..........................................................
WWW...................................................W....
......................................................W....
...WWW.............*.............*.................*..W....
...........!......***.......1...***...........1...***.W....
......WWW..WWWWWWWWWWWWWWWWWWWWWWWWWWWWWWWWWWWWWWWWWWWW....
...........................................................
.........WWW......*............*...........*...............
.................***..........***.........***..............
............WWWWWWWWWWWWWWWWWWWWWWWWWWWWWWWWWWWWWW...W.....
.....................................................W.....
............*.*.*.*.................*.*.*.*..........W.....
....WWWWWWWWWWWWWWWWWWWWWWWWWWWWWWWWWWWWWWWWWWWWWWWWWW.....
...........................................................
!...........1..................1...................1....F.!
WWWWWWWWWWWWWWWWWWWWWWWWWWWWWWWWWWWWWWWWWWWWWWWWWWWWWWWWWWW